____RR____
___GGGG___
__BBBBBB__
_RRRRGGGG_
BBBBBBBBBB